Les 15
ID 
NL

agak -> enigszins; ietwat
anggap; menganggap -> beschouwen
beberapa -> enkele; een aantal
Saya berada di kota. -> Ik ben in de stad.
biasa -> gewoon; gewend
buah mata -> lieveling
buah pikiran -> idee
buruk -> slecht
cerah -> helder (van weer of lucht)
cuci; mencuci -> wassen
cukup -> genoeg; voldoende
dapat; mendapat -> krijgen
dengar; mendengar -> horen; luisteren
kedengaran -> hoorbaar; te horen
habis -> op
menghabiskan -> opmaken
hawa -> lucht; het weer
Hawa di Belanda sangat buruk. -> Het weer in Nederland is erg slecht.
hubungan -> verbinding; relatie
isi -> inhoud
mengisi -> vullen; invullen (van formulier)
jarang -> zelden
kedua -> tweede
keringat; berkeringat -> zweten
ketiga -> derde
kumpul; berkumpul -> samenkomen; samen zijn
lucu -> leuk; grappig
melalui -> langs; via; passeren
meskipun -> hoewel
pada -> aan; op
paling sedikit -> op zijn minst
pendek -> kort
permisi -> toestemming
pertama -> eerste
pirang -> blond
rambut -> haar
rasa; merasa -> voelen
Saya merasa santai. -> Ik voel me ontspannen.
Hari ini hawa sejuk. -> Vandaag is het fris buiten.
seperti -> als; zoals
soal -> kwestie
tanda -> teken
tanda tangan -> handtekening
tiap -> elk; ieder
meninggalkan -> achterlaten; achter zich laten
tolong; menolong -> helpen
tukang kebun -> tuinman
tukang sepatu -> schoenenmaker
Peter berkaca-mata. -> Peter draagt een bril.
Mereka tidak bersepatu. -> Zij hebben geen schoenen aan.
Nanti malam pakai apa? -> Wat dragen we vanavond?
Kami bertiga naik bis. -> Wij gaan met z'n drieen met de bus.
Kami tiga orang naik bis. -> Wij gaan met z'n drieen met de bus.
Mereka beranak tiga. -> Zij hebben drie kinderen.
Dia berhati baik. -> Hij heeft een goed hart.
Dia punya hati baik. -> Hij heeft een goed hart.
Dia hatinya baik. -> Hij heeft een goed hart.
Mereka anaknya tiga. -> Zij hebben drie kinderen.
seorang mahasiswa -> een student
sepasang sepatu -> een paar schoenen
sebuah kotak -> een doos
keduanya -> allebei
ketiganya -> alledrie
pernah -> ooit
sekali-sekali -> een enkele keer
Dari jauh kelihatan olehnya rumah neneknya. -> Uit de verte kan hij het huis van oma zien.
Paman dan bibi kelihatan susah. -> Oom en tante zien er moe uit.
Rumahmu belum dapat dilihat? -> Kan jouw huis nog niet gezien worden?